{
  "id": "level-5",
  "name": "Tower Maze",
  "grid": [
    "......E......",
    "......#......",
    "......^.....F",
    "...^^#.#..#..",
    "...^#...#.^..",
    "...#....#F...",
    "..#F.^^..#...",
    "..#..^^.##...",
    ".F...^^..#...",
    "..F.....F#...",
    "...#...###...",
    "##########^^^"],
  "snake": [[6,10],[5,10]],
  "facing": "right"
}
