{
  "id": "level-ice",
  "name": "Frozen Pillars",
  "grid": [
    "....E............",
    "...........#.#...",
    "..#........#.#...",
    "..###.....##.#...",
    "....#.....##.#...",
    "..#.#.....##.#...",
    "......FFF........",
    "...##.....###....",
    "...##.....##.....",
    ".................",
    "................."],
  "snake": [[4, 2], [3, 2], [3, 1]],
  "facing": "right"
}
